NO textures/wall.xpm
SO textures/wall.xpm
WE textures/wall.xpm
EA textures/wall.xpm
F 60,60,60
C 120,120,180

111111111111
100000000001
100001100001
1000N0000001
111111111111
